___T___T__
____T__T__
TTX_______
__________
TT________
TT___T_T__
T__T_T____
T____T_T__